NO ./textures/NO.xpm
WE ./textures/WE.xpm
EA ./textures/EA.xpm
SO ./textures/SO.xpm

F 100,110,33
C 130,30,254

        1111111111111111111111111
        1000000000110000000000001
        1011000001110000000000001
        1001000000000000001000001
111111111011000001110000000000001
100000000011000001110111111111111
11110111111111011100000010001
11110111111111011101010010001
11000000110101011100000010001
1000S00000000001100000010001
10000000000000001101010010001
110000011101010111110111101
11110111 1110101 101111010001
11111111 1111111 111111111111